# Interactive
#TODO: Review and Standardize

[ Not holding items ]=[ Ne tenas aĵojn ]
[Cannot pull valve]=[Ne povas entiri valvon]
[Hands full]=[Manoj plenaj]
[Nothing to store]=[Neniu por stoki]
[Wait for ship to land]=[Atendu, ke la kosmoŝipo alteriĝos]

# A-M
Access terminal : [E]=Aliri Terminalon ： [E]
Beam up : [E]=Teleporti : [E]
Charge item : [E]=Ŝargi Aĵon ： [E]
Climb : [E]=Grimpi ： [E]
Close door : [E]=Fermi Pordon ： [E]
Confirm: [B]   |   Rotate: [R]   |   Store: [X]=Konfermi: [B]  |   Pivoti: [R]  |   Formeti: [X]
Disable speaker: [E]=Malŝalti Parolilo: [E]
Enter : [E]=Eniri : [E]
Enter: [E]=Eniri: [E]
Exit : [E]=Eliri : [E]
Exit: [E]=Eliri： [E]
Fire : [LMB]= Pafi : [LMB]
Flip switch: [E]=Baskuligi: [E]
Flush: [E]=Fluvi: [E]
Get log : [E]=Preni Komentarion ： [E]
Grab : [E]=Preni： [E]
Grab: [E]=Preni： [E]
Inspect: [Z]=Ekzameni： [Z]
Land ship : [E]=Alteriĝi Kosmoŝipon ： [E]
Let go : [E]=Ellasi ： [E]
Lift glass : [E]=Alti Vitron ： [E]

# N-Z
Open : [E]=Malfermi：[E]
Open door : [E]=Malfermi Pordon ： [E]

Open hatch : [E]=Malfermi Lukon：[E]
Open: [E]=Malfermi： [E]
Open gift : [LMB]=Malferma Donaco : [LMB]
Pop up ladder : [LMB]=Malfoldi Ŝtuparon: [LMB]
Power button : [Q]=Potenca Butono ：[Q]
Pull pin : [LMB]=Tiri Pinglo : [LMB]
Quit terminal : [TAB]=Lasi Terminalon ： [TAB]
Reload : [E]=Reŝarĝi : [E]
Ring bell: [E]=Sonorigi Sonilon： [E]
Scan : [RMB]=Skani ： [RMB]
Sell item : [E]=Vendi Aĵon ： [E]
Send voice : [LMB]=Sendi Voĉon ： [LMB]
Shake can : [Q]=Agitigi Ladskatolo : [Q]
Sprint: [Shift]=Sprinti：[Shift]
Spray : [LMB]=Spraji : [LMB]
Squeeze : [E]=Stringi: [E]
Start game : [E]=Ekludi : [E]
Start ship : [E]=Aktivigi Kosmoŝipo : [E]
Store item : [E]=Formeti Aĵon : [E]
Swing shovel : [LMB]=Svingi Fosilon：[LMB]
Swing sign : [LMB]=Svingi Signalon：[LMB]
Switch camera : [E]=Ŝanĝi Fotilon : [E]
Switch lights : [E]=Baskuligi Lumoj : [E]
Take TZP : [LMB]=Ingesti TZP-n : [LMB]
Toggle light : [LMB]=Baskuligi Lumon: [LMB]
Toggle music : [LMB]=Baskuligi Muzikon: [LMB]
Turn on/off : [E]=Ŝalti/Malŝalti：[E]
Turn safety on: [Q]=Ŝalti Sekurecon: [Q]

Turn page : [Q/E]=Ŝanĝi Folion: [Q/E]
Use airhorn : [LMB]=：Uzi Aerkornon[LMB]
Use cash register : [LMB]=Uzi Kasregistrilon : [LMB]
Use door : [E]=Uzi Pordon ： [E]
Use grenade : [LMB]=Uzi Grenado : [LMB]
Use hairdryer : [LMB]=Uzi Harsekigilon ： [LMB]
Use DIY-Flashbang : [LMB]=Uzi FĜM-Ekbru-brileton
Use horn : [LMB]=Uzi Kornon ： [LMB]
Use key : [LMB]=Uzi Ŝlosilon : [LMB]
Use key : [LMB]=Uzi Ŝlosilon ： [LMB]
Use ladder : [E]=Uzi Ŝtuparon ： [E]
Use remote : [LMB]=Uzi Teleregilon ： [LMB]
Walk : [W/A/S/D]=Marŝi : [W/A/S/D]

sr:"^(.+) \((.+)\) : (.+)\n$"=$1 ($2)：$3